16 16
S###..#..###..#.
.##....#..#.##..
.#...#.##..####.
..#.#.#..#.##..#
#....##..#.#..#.
.###...#.#..#...
....#....###..#.
..####.###..#.#.
.##.##..####....
..##.##.#.#.##..
#.......##.#....
.#.##..##.##.#.#
.#####...#...#..
##....##.....##.
....##..####..#.
##.......######G